11111111111
10C0000x001
10000000P01
10000E00001
11111111111
