1111111111
10P000001
100000E001
1000000001
100C000001
1111111111