11011111111
10C00000001
10000000P01
10000E00001
11111111111
