11111111111
10000000001
10000000P01
10000E00001
11111111111
