11111111111
10C00000001
10000000001
10000E00001
11111111111