11111111111
10C00000001
10000000P01
10000000001
11111111111