1111111111
10C0000001
1000000P01
1000E00001
1000000001
1000000001
1000000001
1000000001
1000000001
1111111111