11111111111
10C00000001
10000000P01
10P00E00001
11111111111