11111111111
10C00E00001
10000000P01
10000000E01
11111111111