111111111111111111111
10C000000000000000001
10000000C000000000001
100C0000001000C000101
100000001000000000001
1000C000C00000C000011
1P0000001000000000001
101000001000000000001
1001000011101111C1001
10C10000C01000E101001
111111111111111111111
