11111111111
10P000E0001
10000000C01
10000000001
10000000111
10010000001
10010000001
100C0000001
11111111111
