11111111111
10C001E1001
10000010C01
100C00000P1
11111111111
